XXXXXXXXXXXXXXXXXXXXX
XBX0L0X0D00X00000000X
X0X0X000XXSX0000000X
X000XEXXXX0X00000000X
XXX0XXX00X0X00000000X
XSX0X0X00X0X00000000X
X0X0X0XX0X0X00000000X
X000000X0X0X00000000X
XXXXXX0XXX0XXX000000X
X00XS00000000X000000X
X00XXXXXXXXX0X000000X
X0000000000X0X000000X
X0000000000X0X000000X
X0000000000X0X000000X
X0000000000X0X000000X
X0000000000X0X000000X
X0000000000X0X000000X
X0000000000X0X000000X
X00000000XXX0X000000X
X00000000X000X000000X
XXXXXXXXXXXXXXXXXXXXX