XXXXXXXXXXXXXXXXXXXXX
X0000000000000000000X
X0000000000000000000X
X0000000000000000000X
X0000000B00000000000X
X00000000EX000000000X
X00000000XX000000000X
X0000000000000000000X
X0000000000000000000X
X0000000000000000000X
X0000000000000000000X
X0000000000000000000X
X0000000000000000000X
X0000000000000000000X
X0000000000000000000X
X0000000000000000000X
X0000000000000000000X
X0000000000000000000X
X0000000000000000000X
X0000000000000000000X
XXXXXXXXXXXXXXXXXXXXX