XXXXXXXXXXXXXXXXXXXXX
XB0000X0000000X00000X
XXXXX0X0X0XXX0X0XXX0X
X000X0X0X000X000XSX0X
X0XDX0X0XXX0XXXXX0X0X
X0XEX0X000X0000000X0X
X0XXX0XXX0XXXXXXXXXDX
X000X00000X0000000X0X
X0XXXX0XXXX0XXXXX0X0X
X0X00X0000X00000X000X
X0XX0XX0X0XXXXX0XXXXX
X0X000X0X0X00LX0X000X
X0X0X0XXX0X0XXX0X0X0X
X000X0X000X000X000XXX
XXXXX0X0XXXX0XLXX000X
X000X0X000000X0000X0X
X0XLX0XXXXX0XXXXXXX0X
X0XXX00000X00SX00000X
X000XXX0X0XXXXXdXXX0X
X0X00000X0000000XS00X
XXXXXXXXXXXXXXXXXXXXX