XXXXXXXXXXXXXXXXXXXXX
XB0L000DSX0000000000X
X000000X0X0000000000X
XIXXXEXXXX0000000000X
XXXXXXX0000000000000X
X0000000000000000000X
X0000000000000000000X
X0000000000000000000X
X0000000000000000000X
X0000000000000000000X
X0000000000000000000X
X0000000000000000000X
X0000000000000000000X
X0000000000000000000X
X0000000000000000000X
X0000000000000000000X
X0000000000000000000X
X0000000000000000000X
X0000000000000000000X
X0000000000000000000X
XXXXXXXXXXXXXXXXXXXXX