XXXXXXXXXXXXXXXXXXXXX
X0000000000000000000X
X0000000000000000000X
X0XXXXX0XXXXX0000000X
X0X000XXX000X0000000X
X0X0X00000X0X0000000X
X0X0X0XXX0X0X0000000X
X0X0X00B00X0X0000000X
X0X0X0XXX0X0X0000000X
X0X0X0X0X0X0X0000000X
X0X000000000X0000000X
X0XXXXXXXXXXX0000000X
X0000000000000000000X
X0000000000000000000X
X0000000000000000000X
X0000000000000000000X
X0000000000000000000X
X0000000000000000000X
X0000000000000000000X
X0000000000000000000X
XXXXXXXXXXXXXXXXXXXXX