XXXXXXXXXXXXXXXXXXXXX
X0000000000000000000X
X0000000000000000000X
X0000000X00000000000X
X000000XBX0000000000X
X00000000EX000000000X
X00000000XX000000000X
X0000000000000000000X
X0000000000000000000X
X0000000000000000000X
X0000000000000000000X
X0000000000000000000X
X0000000000000000000X
X0000000000000000000X
X0000000000000000000X
X0000000000000000000X
X0000000000000000000X
X0000000000000000000X
X0000000000000000000X
X0000000000000000000X
XXXXXXXXXXXXXXXXXXXXX