XXXXXXXXXXXXXXXXXXXXX
XB00000X000000000000X
XXXXdX0X000000000000X
XL000X0XXX0000000000X
XXXXDX00SX0000000000X
XE000XXXXX0000000000X
XXXXXX00000000000000X
X0000000000000000000X
X0000000000000000000X
X0000000000000000000X
X0000000000000000000X
X0000000000000000000X
X0000000000000000000X
X0000000000000000000X
X0000000000000000000X
X0000000000000000000X
X0000000000000000000X
X0000000000000000000X
X0000000000000000000X
X0000000000000000000X
XXXXXXXXXXXXXXXXXXXXX
