XXXXXXXXXXXXXXXXXXXXX
XB0L000DSX0000000000X
X000000X0X0000000000X
XIXXXEXXXX0000000000X
XXXXXXX00000000000000
000000000000000000000
000000000000000000000
000000000000000000000
000000000000000000000
000000000000000000000
000000000000000000000
000000000000000000000
000000000000000000000
000000000000000000000
000000000000000000000
000000000000000000000
000000000000000000000
000000000000000000000
000000000000000000000
000000000000000000000
000000000000000000000