XXXXXXXXXXXXXXXXXXXXX
XB0000d0D0000000X0S0X
XXXXXXX0XXX0XXX0X0XXX
X00000X0X000X000X000X
X0XXX0X0X0XXX0XXXXX0X
X0X000X0X0X0X0X000X0X
X0X0XXX0X0X0X0D0XSX0X
XLX0XL00X0X000X0X0X0X
XXX0XXXXX0X0XXX0X0X0X
XEX0X00000X00000X000X
X0X0X0XXXSXXXXXXXXXXX
X0X0X0X000X000000000X
X0X0XDXXXXX0XXXXXXX0X
X000X0d00000XLX00000X
X0XXX0XXXXXXX0X0XXX0X
X000X000X00000X0X000X
XXX0XXX0X0XXXXX0X0XXX
X0X0X00000X00000XSX0X
X0X0XXXXXXX0XXXXX0X0X
X00000000000X000d000X
XXXXXXXXXXXXXXXXXXXXX