XXXXXXXXXXXXXXXXXXXXX
XB0000X0000000000000X
XXX0X0X0000000000000X
X0XEXXX0000000000000X
X0XXX000000000000000X
X0000000000000000000X
X0000000000000000000X
X0000000000000000000X
X0000000000000000000X
X0000000000000000000X
X0000000000000000000X
X0000000000000000000X
X0000000000000000000X
X0000000000000000000X
X0000000000000000000X
X0000000000000000000X
X0000000000000000000X
X0000000000000000000X
X0000000000000000000X
X0000000000000000000X
XXXXXXXXXXXXXXXXXXXXX