XXXXXXXXXXXXXXXXXXXXX
XBX000X0D00X00000000X
X0X0X000XXSX0000000X
X000X0X0XX0X00000000X
XXX0X0X00X0X00000000X
XSX0XEXX0X0X00000000X
X0X0XXXX0X0X00000000X
X000000XLX0X00000000X
XXXXXX0XXX0XXX000000X
X00XS00000000X000000X
X00XXXXXXXXX0X000000X
X0000000000X0X000000X
X0000000000X0X000000X
X0000000000X0X000000X
X0000000000X0X000000X
X0000000000X0X000000X
X0000000000X0X000000X
X0000000000X0X000000X
X00000000XXX0X000000X
X00000000X000X000000X
XXXXXXXXXXXXXXXXXXXXX