XXXXXXXXXXXXXXXXXXXXX
XB0L000D0X0000000000X
X000000XSX0000000000X
XIX0XEXXXX0000000000X
XXX0XXX0000000000000X
XSX0X0X0000000000000X
X0X0X0XX000000000000X
X000000X000000000000X
XXXXXX0X000000000000X
X00XS00X000000000000X
X00XXXXX000000000000X
X0000000000000000000X
X0000000000000000000X
X0000000000000000000X
X0000000000000000000X
X0000000000000000000X
X0000000000000000000X
X0000000000000000000X
X0000000000000000000X
X0000000000000000000X
XXXXXXXXXXXXXXXXXXXXX